w4 w4 w4 w4 w4 w4 w4 w4 w4 w4 w4
w4 k3 e2 g2 w0 b3 l0 w0 d1 X1 w4
w4 w3 w3 k3 p1 e1 w1 d1 w1 w1 w4
w4 r3 w2 w2 l0 w1 w1 w0 w0 b1 w4
w4 d3 w3 m1 s1 c1 w1 w1 w1 l0 w4
w4 y3 l0 l0 w1 l0 l0 o1 e1 y2 w4
w4 w0 w0 w0 w0 l0 l0 w2 w2 w2 w4
w4 k1 c3 s3 w0 p1 w1 s3 o1 r3 w4 
w4 w0 w1 l0 w0 w0 d1 w0 w0 e3 w4
w4 w0 g1 l0 w0 @1 w2 m1 s1 k4 w4
w4 w4 w4 w4 w4 w4 w4 w4 w4 w4 w4