w0 w0 w0 w0 w0 l0 w1 w2 w3 w4 w5
w0 w0 w0 w0 w0 l0 w0 w0 w0 w0 w0
d1 d2 d3 d4 d5 l0 k1 k2 k3 k4 k5
w0 w0 w0 w0 w0 l0 w0 w0 w0 w0 w0
w0 w1 w0 d1 w0 X1 w0 w0 w0 w0 w0
e1 e2 e3 e4 e5 w0 s1 s2 s3 s4 s5
w0 w0 w0 w0 w0 w0 w0 w0 w0 w0 p4
w0 w0 w0 w0 w0 w0 w0 w0 w0 w0 b3
g1 y2 r3 m4 c5 w0 w0 w0 w0 w0 o2
w0 e0 d0 w0 w0 w0 @1 w0 l0 r1 l0
w0 w0 w0 w0 w0 w0 w0 w0 l0 l0 l0