17
z 9 9 1 8
z 7 0 8 6
z 2 3 2 7
z 1 1 4 1
q 9 8 1 2
q 4 4 5 8
q 7 3 8 9
q 7 7 2 5
q 2 3 2 7
g 1 3 9 2
b 1 5 3 9
p 2 4 7 5
r 3 1 7 9
m 4 3 9 7
y 5 1 5 9
c 7 2 4 5
o 5 7 7 8